0000000000000000
0000000000000000
0000000000000000
0000000000000000
0000000000000000
0000000000100011
0000010000000011
1112222222222211