00000000000000
00000000000000
00000000000000
00100000110000
00300000330000
00000000000000
00002220000211
11111111111111