00000000000
00000000000
00000000000
00000000000
00000000000
11000000000
11212222000
11111111111