0000000000
0000000000
0000000000
0000000000
0000000000
1100000011
1122122211
1111111111